1111111111111111
1010000101000001
1011110101011131
1000000000000101
1110110101111101
1000010000101101
1010010103100001
1010111101101111
1010000141000101
1011110101101101
1000000100000001
1311030000100101
1001011110110111
1101010001100101
1100010100000301
1111111111111111
