1111111111111111
1010000101000001
1011010101010131
1000000000000101
1110010101111001
1000010000101101
1010010103100001
1010111101100111
1010000141000101
1011010101100101
1000000100000001
1311130000100101
1001011111000111
1101010000000101
1100010100000301
1111111111111111
