1111111111111111
1000000000000001
1000000000000031
1000000000000001
1000000000000001
1000000000000001
1000000003000001
1000000000000001
1000000040000001
1000000000000001
1000000000000001
1300030000000001
1000000000000001
1000000000000001
1000000000000301
1111111111111111